               #
   #####        
   #xxx#        
   #...#        
   #...######   
   #o..o....#   
   #...o...p#   
   #...o....#   
   #o..o....#   
   #...######   
   #...######   
   #xxx######   
   ##########   
                
                
#               
